joan	joan	rossi
aden	aden	iyer
andreas	andreas	janssen
dawson	dawson	robert
drew	drew	dominguez
trevor	trevor	malhotra
sasha	sasha	akkineni
penelope	penelope	dubey
israel	israel	de
brisa	brisa	krawczyk
don	don	jackson
monserrat	monserrat	wojciechowski
andreas	andreas	morales
zavier	zavier	de
gregory	gregory	dixit
kaitlyn	kaitlyn	suarez
elaine	elaine	garg
jamir	jamir	roberts
keon	keon	grenier
brennan	brennan	pradhan
jonas	jonas	kapadia
kody	kody	khan
eric	eric	gomes
james	james	chattopadhyay
danna	danna	perera
kianna	kianna	gauthier
ryley	ryley	carlsson
bruno	bruno	cohen
dianna	dianna	dias
lexi	lexi	akkineni
kaya	kaya	costa
juan	juan	mehta
marc	marc	simard
brandi	brandi	malethia
kenna	kenna	agarwal
aiden	aiden	gounder
colin	colin	andersen
reyna	reyna	marino
nina	nina	bianchi
emanuel	emanuel	oliveira
arianna	arianna	kapadia
liam	liam	bedard
howard	howard	malethia
maliyah	maliyah	tremblay
august	august	vazquez
freddy	freddy	oconnor
shreya	shreya	kennedy
jovan	jovan	rego
jamel	jamel	murphy
lorena	lorena	sanchez
harold	harold	poulin
orion	orion	shah
felipe	felipe	jankowski
albert	albert	nogueira
ethan	ethan	hall
brendon	brendon	kowalczyk
clifford	clifford	poirier
ximena	ximena	romero
silas	silas	ruiz
karissa	karissa	varma
kelton	kelton	cloutier
alfonso	alfonso	caron
zane	zane	dhekale
bryant	bryant	wong
shawna	shawna	gounder
nelson	nelson	roux
luciano	luciano	vallampati
ruby	ruby	johnson
genevieve	genevieve	goh
maci	maci	eriksson
kirsten	kirsten	bengtsson
omari	omari	larsen
chyna	chyna	carlsson
amanda	amanda	dupont
mckenna	mckenna	gowda
ralph	ralph	kennedy
landen	landen	carvalho
kareem	kareem	pillai
kya	kya	edwards
harry	harry	srivatsavaya
carley	carley	sangwal
cheyanne	cheyanne	nilsson
viviana	viviana	cote
misael	misael	silva
jolie	jolie	hall
sonny	sonny	kennedy
daniela	daniela	silva
miranda	miranda	smith
renee	renee	teo
gianna	gianna	gutierrez
xzavier	xzavier	petit
raymundo	raymundo	scott
sarina	sarina	romero
moises	moises	jadhav
reilly	reilly	scott
elaine	elaine	martin
allen	allen	leclercq
markus	markus	kale
davin	davin	de
mira	mira	goyal
ahmed	ahmed	singh
donovan	donovan	berg
logan	logan	jackson
